0 1 1 1 1 1 1 1 1 1 1 1 1 1 1 1 1 1 1 1 1 1 1 1 1 1 1 1 1 1 1
0 0 0 0 0 0 0 0 0 0 0 0 0 0 0 0 0 0 0 0 0 0 0 0 0 0 0 0 0 0 0
9 0 0 0 0 0 0 0 8 8 8 8 8 8 8 8 8 8 8 8 8 8 0 0 0 0 0 0 0 0 0
0 0 0 0 0 0 0 1 1 1 1 1 1 1 1 1 1 1 1 1 1 1 1 0 0 0 0 0 0 0 0
0 0 0 0 0 0 8 1 5 2 2 2 2 2 2 2 2 2 2 2 2 7 1 8 0 0 0 0 0 0 0
0 0 0 0 0 0 8 1 2 5 2 2 2 2 2 2 2 2 2 2 7 2 1 8 0 0 0 0 0 0 0
0 0 0 0 0 0 8 1 2 2 5 2 2 2 2 2 2 2 2 7 2 2 1 8 0 0 0 0 0 0 0
0 0 0 0 0 0 8 1 2 2 2 1 1 1 1 1 1 1 1 2 2 2 1 8 8 8 0 0 0 0 0
0 8 8 8 8 8 8 1 2 2 2 1 8 8 8 8 8 8 1 2 2 2 1 1 1 1 1 0 0 0 0
1 1 1 1 1 1 1 1 2 2 2 1 8 0 0 0 0 8 1 2 2 5 2 2 2 7 1 8 0 0 0
3 2 2 2 2 2 2 2 6 2 2 1 8 0 0 0 0 8 1 2 5 2 2 2 7 2 1 8 0 0 0
3 2 2 2 2 2 2 2 2 6 2 1 8 0 0 0 0 8 1 5 2 2 2 7 2 2 1 8 0 0 0
3 2 2 2 2 2 2 2 2 2 6 1 8 0 0 0 0 0 1 1 1 1 1 2 2 2 1 8 0 0 0
1 1 1 1 1 1 1 1 1 1 1 1 0 0 0 0 0 0 0 8 8 8 1 2 2 2 1 8 0 0 0
0 8 8 8 8 8 8 8 8 8 8 0 0 0 0 0 0 0 0 0 0 8 1 2 2 2 1 8 0 0 0
0 0 0 0 0 0 0 0 0 0 0 0 0 0 0 0 0 0 0 0 0 8 1 2 2 2 1 8 0 0 0
0 0 0 0 0 0 0 0 0 0 0 0 0 0 0 0 0 0 0 0 0 0 1 2 2 2 1 0 0 0 0
